#s###########
# #         #
# # ##### # #
# # # ### # #
#      #  # #
######e######
