#######s#
# #     #
# ##### #
#   #   #
### # ###
#     ###
#e#######
